000500500500500500500500500500500500500500500500500500500500500500500500500500500500500500500500500500500500500500500500500500500500500500
500500500500500500500500500500500500500500500500500500500500500500500500500500500500500500500500500500500500500500500500500500500500500500
500500500500500500500500500500500500500500500500500500500500500500500500500500500500500500500500500500500500500500500500500500500500500500
500500500500500500500500500500500500500500500500500500500500500500500500500500500500500500500500500500500500500500500500500500500500500500
500500500500500500500500500500500500500500500500500500500500500500500500500500500500500500500500500500500500500500500500500500500500500500
500500500500500500000500500500500500500500500500500500500500500500500500500500500500500500500500500500500500500500500500500500500500500500
500500500500500500500500500500500500500500500500500500500500500500500500500500500500500500500500500500500500500500500500500500500500500500
500500500500500500500500500500500500500500500500500500500500500500500500500500500500500500500500500500500500500500500500500500500500500500
500500500500500500500500500500500500500500500500500500500500500500500500500500500500500500500500500500500500500500500500500500500500500500
500500500500500500500500500000000000000000000000000000000000000000000000000000500500500500500500500500500500500500500500500500500500500500
500500500500500500500500500000000000000000000000000000000000000000000000000000500500500500500500500500500500500500500500500500500500500500
500500500500500500500500500000000000000000000000000000000000000000000000000000500500500500500500500500500500500500500500500500500500500500
500500500500500500500500500000000000000000000000000000000000000000000000000000500500500500500500500500500500500500500500500500500500500500
500500500500500500500500500000000000000000000000000000000000000000000000000000500500500500500500500500500500500500500500500500500500500500
500500500500500500500500500000000000000000000000000000000000000000000000000000500500500500500500500500500500500500500500500500500500500500
500500500500500500500500500000000000000000000000000000000000000000000000000000500500500500500500500500500500500500500500500500500500500500
500500500500500500500500500000000000000000000000000000000000000000000000000000500500500500500500500500500500500500500500500500500500500500
500500500500500500500500500000000000000000000000000000000000000000000000000000500500500500500500500500500500500500500500500500500500500500
500500500500500500500500500000000000000000000000000000000000000000000000000000500500500500500500500500500500500500500500500500500500500500
500500500500500500500500500000000000000000000000000000000000000000000000000000500500500500500500500500500500500500500500500500500500500500
500500500500500500500500500500500500500500500500500500500500500500500500500500500500500500500500500500500500500500500500500500500500500500
500500500500500500500500500500500500500500500500500500500500500500500500500500500500500500500500500500500500500500500500500500500500500500
500500500500500500500500500500500500500500500500500500500500500500500500500500500500500500500500500500500500500500500500500500500500500500
500500500500500500500500500500500500500500500500500500500500500500500500500500500500500500500500500500500500500500500500500500500500500500
500500500500500500500500500500500500500500500500500500500500500500500500500500500500500500500500500500500500500500500500500500500500500500
500500500500500500500500500500500500500500500500500500500500500500500500500500500500500500500500500500500500500500500500500500500500500500
500500500500500500500500500500500500500500500500500500500500500500500500500500500500500500500500500500500500500500500500500500500500500500
500500500500500500500500500500500500500500500500500500500500500500500500500500500500500500500500500500500500500500500500500500500500500500
500500500500500500500500500500500500500500500500500500500500500500500500500500500500500500500500500500500500500500500500500500500500500500
500500500500500500500500500500500500500500500500500500500500500500500500500500500500500500500500500500500500500500500500500500500500500500
500500500500500500500500500500500500500500500500500500500500500500500500500500500500500500500500500500500500500500500500500500500500500500
500500500500500500500500500500500500500500500500500500500500500500500500500500500500500500500500500500500500500500500500500500500500500500
500500500500500500500500500500500500500500500500500500500500500500500500500500500500500500500500500500500500500500500500500500500500500000