050050050050050050050050050000050050050050050050050050050050050050050050050050050050050050050050050050050050050050050050050050050050050050050
050050050050050050050050050000000050050050050050050050050050050050050050050050050050050050050050050050050050050050050050050050050050050050050
050050050050050050050050050050000050050050050050050050050050050050050050050050050050050050050050050050050050050050050050050050050050050050050
050050050050050050050050050050000000050050050050050050050050050050050050050050050050050050050050050050050050050050050050050050050050050050050
050050050050050050050050050050000050050050000050050000050050050050050050050050050050050050050050050050050050050050050050050050050050050050050
050050050050050050050050050050000050050050050050050050050050000050050000050000000000000000050050050050050050050050050050050050050050050050050
050050050050050050050050050050000050050050050050050050050050050050050050050050050000000050050050050050050050050050050050050050050050050050050
050050050050050050050050050050000050050050050050050050050050050050050050050000000050050050050050050050050050050050050050050050050050050050050
050050050050050050050050050050000050050050050050050050050050000000000000050050050050050050050050050050050050050050050050050050050050050050050
050050050050050050050050050050000050050050050050050050000000050050050050050050050050050050050050050050050050050050050050050050050050050050050
050050050050050050050050050050000050050050050050050000000050050050050050050050050050050050050050050050050050050050050050050050050050050050050
050050050050050050050050050050050050050050050050050050050050050050050050050050050050050050050050050050050050050050050050050050050050050050050
050050050050050050050050050000050050050050050050050050050050050050050050050050050050050050050050050050050050050050050050050050050050050050050
050050050050050050050050050000050050050050050050050050050050050050050050050050050050050050050050050050050000000000050050050050050050050050050
050050050050050050050050050000050050050050050050050050050050050050050050050050050050050050050050050050000050050000050000000000050050050050050
050050050050050050050050050050050050050050050050050050050050050050050050050050050050050050050050050050000050000000050000000000000050050050050
050050050050050050050050050000050050050050050050050050050050050050050050050050050050050050050050050050000050000050050050050050000000050050050
050050050050050050050050050000050000000000000000000000000000000000000000000000000000000000000000000000000000000000000000050000050000050050050
050050050050050050050050050050050000000000000000000000000000000000000000000000000000000000000000000000000000000000000000000000000050050050050
050050050050050050050050000050050000000000000000000000000000000000000000000000000000000000000000000000000000000000000000050050050050050050050
050050050050050050050050050050050000000000000000000000000000000000000000000000000000000000000000000000000000000000000000000050050050050050050
050050050050050050050050000050050000000000000000000000000000000000000000000000000000000000000000000000000000000000000000050050050050050050050
050050050050050050050050000050050000000000000000000000000000000000000000000000000000000000000000000000000000000000000000050000050050050050050
050050050050050050050050050050050000000000000000000000000000000000000000000000000000000000000000000000000000000000000000050050000050050050050
050050050050050050050050000050050000000000000000000000000000000000000000000000000000000000000000000000000000000000000000050050050050000050050
050050050050050050050000050050050000000000000000000000000000000000000000000000000000000000000000000000000000000000000000050050050050050000050
050050050050050050050050050050050000000000000000000000000000000000000000000000000000000000000000000000000000000000000000050050050050050000050
050050050050050050000050050050050000000000000000000000000000000000000000000000000000000000000000000000000000000000000000050050050050050050000
050050050050050050050050050050050000000000000000000000000000000000000000000000000000000000000000000000000000000000000000050050050050050000000
050050050050050000050050050050050000000000000000000000000000000000000000000000000000000000000000000000000000000000000000050050050050000050050
050050050050050050050050050050050000000000000000000000000000000000000000000000000000000000000000000000000000000000000000050050050050000050050
050050050050000050050050050050050000000000000000000000000000000000000000000000000000000000000000000000000000000000000000050050050000000050050
050050050050050050050050050050050000000000000000000000000000000000000000000000000000000000000000000000000000000000000000050050050000050050050
050050050000050050050050050050050000000000000000000000000000000000000000000000000000000000000000000000000000000000000000050050050000050050050
050050000050050050050050050050050000000000000000000000000000000000000000000000000000000000000000000000000000000000000000050050050000050050050
050000050050050050050050050050050000000000000000000000000000000000000000000000000000000000000000000000000000000000000000050050050000050050050
050050050050050050050050050050050000000000000000000000000000000000000000000000000000000000000000000000000000000000000000050050050000050050050
050000050050050050050050050000050000000000000000000000000000000000000000000000000000000000000000000000000000000000000000050050000000050050050
000000000000000000000000000050050000000000000000000000000000000000000000000000000000000000000000000000000000000000000000000000000050050050050
050050050050050050050050050050050050050050050050050050050000050050050050050050050050050050050050050050050050050050050050000050050050050050050
050050050050050050050050050050050050050050050050050050050050050000050050050050050050050050050050050050050050050050050050000050050050050050050
050050050050050050050050050050050050050050050050050050050050050050050000050000050000050000000050000000000050000000000000000050050050050050050
050050050050050050050050050050050050050050050050050050050050050050050050050050050050050050050050050050050050050050050050000050050050050050050