250250250250250250250250250251251251251251251251251251251251251251251251251251251251251251251251251251251251251251251251251251251251251251251250250250250250250250250250250250250
250250250250250250250250250251251251251251251251251251251251251251251251251251251002002002251251251251251251251251251251251251251251251251251250250250250250250250250250250250250
250250250250250250250250250251251251251251251251251251251251251251251251251251251002002002002002002002002002002002002002002002002251251251251250250250250250250250250250250250250
250250250250250250250250250251251003003003003003003003500251251251251251251251500002002002002002002002002002002002002002002002002251251251251250250250250250250250250250250250250
250250250250250250250250250251251003003003003003003003502502502502502502502502002002002002002002002002002002002002002002002002002251251251251250250250250250250250250250250250250
250250250250250250250250250251251003003003003003003003500251251251251251251251500002002002002002002002002002002002002002002002002251251251251250250250250250250250250250250250250
250250250250250250250250250251251251251251251251251251251251251251251251251251251002002002002002002002002002002002002002002002002251251251251250250250250250250250250250250250250
250250250250250250250250250251251251251251251251251251251251251251251251251251251002002002002002002002002002002002002002002002002251251251251250250250250250250250250250250250250
250250250250250250250250250251251251251251251251251251251251251251251251251251251002002002251251251251251251251251251251251251251251251251251250250250250250250250250250250250250
250250250250250250250250250251251251251251251251251251251251251251251251251251251251251251251251251251251251251251251251251251251251251251251250250250250250250250250250250250250
250250250250250250250250250250250250250250250250250250250250250250250250250250250250250250250250250250250250250250250250250250250250250250250250250250250250250250250250250250250
250250250250250250250250250250250250250250250250250250250250250250250250250250250250250250250250250250250250250250250250250250250250250250250250250250250250250250250250250250250
250250250250250250250250250250250250250250250250250250250250250250250250250250250250250250250250250250250250250250250250250250250250250250250250250250250250250250250250250250250
250250250250250250250250250250250250250250250250250250250250250250250250250250250250250250250250250250250250250250250250250250250250250250250250250250250250250250250250250250250
250250250250250250250250250250250250250250250250250250250250250250250250250250250250250250250250250250250250250250250250250250250250250250250250250250250250250250250250250250250
250250250250250250250250250250250250250250250250250250250250250250250250250250250250250250250250250250250250250250250250250250250250250250250250250250250250250250250250250250250
250250250250250250250250250250250250250250250250250250250250250250250250250250250250250250250250250250250250250250250250250250250250250250250250250250250250250250250250250250250
250250250250250250250250250250250250250250250250250250250250250250250250250250250250250250250250250250250250250250250250250250250250250250250250250250250250250250250250250250250
250250250250250250250250250250250250250250250250250250250250250250250250250250250250250250250250250250250250250250250250250250250250250250250250250250250250250250250250250250250
250250250250250250250250250250250250250250250250250250250250250250250250250250250250250250250250250250250250250250250250250250250250250250250250250250250250250250250250250250250
250250250250250250250250250250250250250250250250250250250250250250250250250250250250250250250250250250250250250250250250250250250250250250250250250250250250250250250250250250250
250250250250250250250250250250250250250250250250250250250250250250250250250250250250250250250250250250250250250250250250250250250250250250250250250250250250250250250250250250250
250250250250250250250250250250250250250250250250250250250250250250250250250250250250250250250250250250250250250250250250250250250250250250250250250250250250250250250250250250250
250250250250250250250250250250250250250250250250250250250250250250250250250250250250250250250250250250250250250250250250250250250250250250250250250250250250250250250250250250250
250250250250250250250250250250250250250250250250250250250250250250250250250250250250250250250250250250250250250250250250250250250250250250250250250250250250250250250250250250250
250250250250250250250250250250250250250250250250250250250250250250250250250250250250250250250250250250250250250250250250250250250250250250250250250250250250250250250250250250250
250250250250250250250250250250250250250250250250250250250250250250250250250250250250250250250250250250250250250250250250250250250250250250250250250250250250250250250250250250250
250250250250250250250250250250250250250250250250250250250250250250250250250250250250250250250250250250250250250250250250250250250250250250250250250250250250250250250250250250250
250250250250250250250250250250250250250250250250250250250250250250250250250250250250250250250250250250250250250250250250250250250250250250250250250250250250250250250250250250250
250250250250250250250250250250250250250250250250250250250250250250250250250250250250250250250250250250250250250250250250250250250250250250250250250250250250250250250250250250250
250250250250250250250250250250250250250250250250250250250250250250250250250250250250250250250250250250250250250250250250250250250250250250250250250250250250250250250250250250250
250250250250250250250250250250250250250250250250250250250250250250250250250250250250250250250250250250250250250250250250250250250250250250250250250250250250250250250250250250250
250250250250250250250250250250250250250250250250250250250250250250250250250250250250250250250250250250250250250250250250250250250250250250250250250250250250250250250250250250250
250250250250250250250250250250250250250250250250250250250250250250250250250250250250250250250250250250250250250250250250250250250250250250250250250250250250250250250250250250250
250250250250250250250250250250250250250250250250250250250250250250250250250250250250250250250250250250250250250250250250250250250250250250250250250250250250250250250250250250250
250250250250250250250250250250250250250250250250250250250250250250250250250250250250250250250250250250250250250250250250250250250250250250250250250250250250250250250250250250250
250250250250250250250250250250250250250250250250250250250250250250250250250250250250250250250250250250250250250250250250250250250250250250250250250250250250250250250250250250250
250250250250250250250250250250250250250250250250250250250250250250250250250250250250250250250250250250250250250250250250250250250250250250250250250250250250250250250250250250250
250250250250250250250250250250250250250250250250250250250250250250250250250250250250250250250250250250250250250250250250250250250250250250250250250250250250250250250250250250250
250250250250250250250250250250250250250250250250250250250250250250250250250250250250250250250250250250250250250250250250250250250250250250250250250250250250250250250250250250250
250250250250250250250250250250250250250250250250250250250250250250250250250250250250250250250250250250250250250250250250250250250250250250250250250250250250250250250250250250250
250250250250250250250250250250250250250250250250250250250250250250250250250250250250250250250250250250250250250250250250250250250250250250250250250250250250250250250250250250250
250250250250250250250250250250250250250250250250250250250250250250250250250250250250250250250250250250250250250250250250250250250250250250250250250250250250250250250250250250250
250250250250250250250250250250250250250250250250250250250250250250250250250250250250250250250250250250250250250250250250250250250250250250250250250250250250250250250250250250250