051051000000000000000000000000000000000000000000000000000000000000000000000000000000000000000000000000000000000000000000000000000000000000000000000000000000000000000000000000000000000000000000000000000000000000000000000000000000000000000000000000000000000000000000000000000000000000000000000000000000000000000000000000000000000000000000000000000000000000000000000000000000000
051051000000000000000000000000000000000000000000000000000000000000000000000000000000000000000000000000000000000000000000000000000000000000000000000000000000000000000000000000000000000000000000000000000000000000000000000000000000000000000000000000000000000000000000000000000000000000000000000000000000000000000000000000000000000000000000000000000000000000000000000000000000000
051051000000000000000000000000000000000000000000000000000000000000000000000000000000000000000000000000000000000000000000000000000000000000000000000000000000000000000000000000000000000000000000000000000000000000000000000000000000000000000000000000000000000000000000000000000000000000000000000000000000000000000000000000000000000000000000000000000000000000000000000000000000000
051051000000000000000000000000000000000000000000000000000000000000000000000000000000000000000000000000000000000000000000000000000000000000000000000000000000000000000000000000000000000000000000000000000000000000000000000000000000000000000000000000000000000000000000000000000000000000000000000000000000000000000000000000000000000000000000000000000000000000000000000000000000000
051051000000000000000000000000000000000000000000000000000000000000000000000000000000000000000000000000000000000000000000000000000000000000000000000000000000000000000000000000000000000000000000000000000000000000000000000000000000000000000000000000000000000000000000000000000000000000000000000000000000000000000000000000000000000000000000000000000000000000000000000000000000000
051051000000000000000000000000000000000000000000000000000000000000000000000000000000000000000000000000000000000000000000000000000000000000000000000000000000000000000000000000000000000000000000000000000000000000000000000000000000000000000000000000000000000000000000000000000000000000000000000000000000000000000000000000000000000000000000000000000000000000000000000000000000000
050050050050050050050050050050050050050050050050050050050050050050050050050050050050050050050050050050050050050050050050050050050050050050050050050050050050050050050050050050050050050050050050050050050050050050050050050050050050050050000000000000000000050050050050050050050050050050050050050050050050050050050000000000000000000000000000000000000000000000000000000000000000000
050050050050050050050050050050050050050050050050050050050050050050050050050050050050050050050050050050050050050050050050050050050050050050050050050050050050050050050050050050050050050050050050050050050050050050050050050050050050050050000000000000000000050050050050050050050050050050050050050050050050050050050050050050050050050050050050050050050050050050050050050050050050050
050050050050050050050050050050050050050050050050050050050050050050050050050050050050050050050050050050050050050050050050050050050050050050050050050050050050050050050050050050050050050050050050050050050050050050050050050050050050050050000000000000000000050050050050050050050050050050050050050050050050050050050050050050050050050050050050050050050050050050050050050050050050050
050050050050050050050050050050050050050050050050050050050050050050050050050050050050050050050050050050050050050050050050050050050050050050050050050050050050050050050050050050050050050050050050050050050050050050050050050050050050050050000000000000000000050050050050050050050050050050050050050050050050050050050050050050050050050050050050050050050050050050050050050050050050050
050050050050050050050050050050050050050050050050050050050050050050050050050050050050050050050050050050050050050050050050050050050050050050050050050050050050050050050050050050050050050050050050050050050050050050050050050050050050050050000000000000000000050050050050050050050050050050050050050050050050050050050050050050050050050050050050050050050050050050050050050050050050050
050050050050050050050050050050050050050050050050050050050050050050050050050050050050050050050050050050050050050050050050050050050050050050050050050050050050050050050050050050050050050050050050050050050050050050050050050050050050050050000000000000000000050050050050050050050050050050050050050050050050050050050050050050050050050050050050050050050050050050050050050050050050050
050050050050050050050050050050050050050050050050050050050050050050050050050050050050050050050050050050050050050050050050050050050050050050050050050050050050050050050050050050050050050050050050050050050050050050050050050050050050050050000000000000000000050050050050050050050050050050050050050050050050050050050050050050050050050050050050050050050050050050050050050050050050050
050050050050050050050050050050050050050050050050050050050050050050050050050050050050050050050050050050050050050050050050050050050050050050050050050050050050050050050050050050050050050050050050050050050050050050050050050050050050050050000000000000000000050050050050050050050050050050050050050050050050050050050050050050050050050050050050050050050050050050050050050050050050050
050050050050050050050050050050050050050050050050050050050050050050050050050050050050050050050050050050050050050050050050050050050050050050050050050050050050050050050050050050050050050050050050050050050050050050050050050050050050050050000000000000000000050050050050050050050050050050050050050050050050050050050050050050050050050050050050050050050050050050050050050050050050050
050050050050050050050050050050050050050050050050050050050050050050050050050050050050050050050050050050050050050050050050050050050050050050050050050050050050050050050050050050050050050050050050050050050050050050050050050050050050050050000000000000000000050050050050050050050050050050050050050050050050050050050050050050050050050050050050050050050050050050050050050050050050050
050050050050050050050050050050050050050050050050050050050050050050050050050050050050050050050050050050050050050050050050050050050050050050050050050050050050050050050050050050050050050050050050050050050050050050050050050050050050050050000000000000000000050050050050050050050050050050050050050050050050050050050050050050050050050050050050050050050050050050050050050050050050050
050050050050050050050050050050050050050050050050050050050050050050050050050050050050050050050050050050050050050050050050050050050050050050050050050050050050050050050050050050050050050050050050050050050050050050050050050050050050050050000000000000000000050050050050050050050050050050050050050050050050050050050050050050050050050050050050050050050050050050050050050050050050050
050050050050050050050050050050050050050050050050050050050050050050050050050050050050050050050050050050050050050050050050050050050050050050050050050050050050050050050050050050050050050050050050050050050050050050050050050050050050050050000000000000000000050050050050050050050050050050050050050050050050050050050050050050050050050050050050050050050050050050050050050050050050050
050050050050050050050050050050050050050050050050050050050050050050050050050050050050050050050050050050050050050050050050050050050050050050050050050050050050050050050050050050050050050050050050050050050050050050050050050050050050050050000000000000000000050050050050050050050050050050050050050050050050050050050050050050050050050050050050050050050050050050050050050050050050050
050050050050050050050050050050050050050050050050050050050050050050050050050050050050050050050050050050050050050050050050050050050050050050050050050050050050050050050050050050050050050050050050050050050050050050050050050050050050050050000000000000000000050050050050050050050050050050050050050050050050050050050050050050050050050050050050050050050050050050050050050050050050050
050050050050050050050050050050050050050050050050050050050050050050050050050050050050050050050050050050050050050050050050050050050050050050050050050050050050050050050050050050050050050050050050050050050050050050050050050050050050050050000000000000000000050050050050050050050050050050050050050050050050050050050050050050050050050050050050050050050050050050050050050050050050050
050050050050050050050050050050050050050050050050050050050050050050050050050050050050050050050050050050050050050050050050050050050050050050050050050050050050050050050050050050050050050050050050050050050050050050050050050050050050050050000000000000000000050050050050050050050050050050050050050050050050050050050050050050050050050050050050050050050050050050050050050050050050050
050050050050050050050050050050050050050050050050050050050050050050050050050050050050050050050050050050050050050050050050050050050050050050050050050050050050050050050050050050050050050050050050050050050050050050050050050050050050050050000000000000000000050050050050050050050050050050050050050050050050050050050050050050050050050050050050050050050050050050050050050050050050050
050050050050050050050050050050050050050050050050050050050050050050050050050050050050050050050050050050050050050050050050050050050050050050050050050050050050050050050050050050050050050050050050050050050050050050050050050050050050050050000000000000000000050050050050050050050050050050050050050050050050050050050050050050050050050050050050050050050050050050050050050050050050050
050050050050050050050050050050050050050050050050050050050050050050050050050050050050050050050050050050050050050050050050050050050050050050050050050050050050050050050050050050050050050050050050050050050050050050050050050050050050050050000000000000000000050050050050050050050050050050050050050050050050050050050050050050050050050050050050050050050050050050050050050050050050050
050050050050050050050050050050050050050050050050050050050050050050050050050050050050050050050050050050050050050050050050050050050050050050050050050050050050050050050050050050050050050050050050050050050050050050050050050050050050050050000000000000000000050050050050050050050050050050050050050050050050050050050050050050050050050050050050050050050050050050050050050050050050050
050050050050050050050050050050050050050050050050050050050050050050050050050050050050050050050050050050050050050050050050050050050050050050050050050050050050050050050050050050050050050050050050050050050050050050050050050050050050050050000000000000000000050050050050050050050050050050050050050050050050050050050050050050050050050050050050050050050050050050050050050050050050050
050050050050050050050050050050050050050050050050050050050050050050050050050050050050050050050050050050050050050050050050050050050050050050050050050050050050050050050050050050050050050050050050050050050050050050050050050050050050050050000000000000000000050050050050050050050050050050050050050050050050050050050050050050050050050050050050050050050050050050050050050050050050050
050050050050050050050050050050050050050050050050050050050050050050050050050050050050050050050050050050050050050050050050050050050050050050050050050050050050050050050050050050050050050050050050050050050050050050050050050050050050050050000000000000000000050050050050050050050050050050050050050050050050050050050050050050050050050050050050050050050050050050050050050050050050050
050050050050050050050050050050050050050050050050050050050050050050050050050050050050050050050050050050050050050050050050050050050050050050050050050050050050050050050050050050050050050050050050050050050050050050050050050050050050050050000000000000000000050050050050050050050050050050050050050050050050050050050050050050050050050050050050050050050050050050050050050050050050050
050050050050050050050050050050050050050050050050050050050050050050050050050050050050050050050050050050050050050050050050050050050050050050050050050050050050050050050050050050050050050050050050050050050050050050050050050050050050050050000000000000000000050050050050050050050050050050050050050050050050050050050050050050050050050050050050050050050050050050050050050050050050050
050050050050050050050050050050050050050050050050050050050050050050050050050050050050050050050050050050050050050050050050050050050050050050050050050050050050050050050050050050050050050050050050050050050050050050050050050050050050050050000000000000000000050050050050050050050050050050050050050050050050050050050050050050050050050050050050050050050050050050050050050050050050050
050050050050050050050050050050050050050050050050050050050050050050050050050050050050050050050050050050050050050050050050050050050050050050050050050050050050050050050050050050050050050050050050050050050050050050050050050050050050050050000000000000000000050050050050050050050050050050050050050050050050050050050050050050050050050050050050050050050050050050050050050050050050050
050050050050050050050050050050050050050050050050050050050050050050050050050050050050050050050050050050050050050050050050050050050050050050050050050050050050050050050050050050050050050050050050050050050050050050050050050050050050050050000000000000000000050050050050050050050050050050050050050050050050050050050050050050050050050050050050050050050050050050050050050050050050050
050050050050050050050050050050050050050050050050050050050050050050050050050050050050050050050050050050050050050050050050050050050050050050050050050050050050050050050050050050050050050050050050050050050050050050050050050050050050050050000000000000000000050050050050050050050050050050050050050050050050050050050050050050050050050050050050050050050050050050050050050050050050050
050050050050050050050050050050050050050050050050050050050050050050050050050050050050050050050050050050050050050050050050050050050050050050050050050050050050050050050050050050050050050050050050050050050050050050050050050050050050050050000000000000000000050050050050050050050050050050050050050050050050050050050050050050050050050050050050050050050050050050050050050050050050050
050050050050050050050050050050050050050050050050050050050050050050050050050050050050050050050050050050050050050050050050050050050050050050050050050050050050050050050050050050050050050050050050050050050050050050050050050050050050050050000000000000000000050050050050050050050050050050050050050050050050050050050050050050050050050050050050050050050050050050050050050050050050050
050050050050050050050050050050050050050050050050050050050050050050050050050050050050050050050050050050050050050050050050050050050050050050050050050050050050050050050050050050050050050050050050050050050050050050050050050050050050050050000000000000000000050050050050050050050050050050050050050050050050050050050050050050050050050050050050050050050050050050050050050050050050050
050050050050050050050050050050050050050050050050050050050050050050050050050050050050050050050050050050050050050050050050050050050050050050050050050050050050050050050050050050050050050050050050050050050050050050050050050050050050050050000000000000000000050050050050050050050050050050050050050050050050050050050050050050050050050050050050050050050050050050050050050050050050050
050050050050050050050050050050050050050050050050050050050050050050050050050050050050050050050050050050050050050050050050050050050050050050050050050050050050050050050050050050050050050050050050050050050050050050050050050050050050050050000000000000000000050050050050050050050050050050050050050050050050050050050050050050050050050050050050050050050050050050050050050050050050050
050050050050050050050050050050050050050050050050050050050050050050050050050050050050050050050050050050050050050050050050050050050050050050050050050050050050050050050050050050050050050050050050050050050050050050050050050050050050050050000000000000000000050050050050050050050050050050050050050050050050050050050050050050050050050050050050050050050050050050050050050050050050050
050050050050050050050050050050050050050050050050050050050050050050050050050050050050050050050050050050050050050050050050050050050050050050050050050050050050050050050050050050050050050050050050050050050050050050050050050050050050050050000000000000000000050050050050050050050050050050050050050050050050050050050050050050050050050050050050050050050050050050050050050050050050050
050050050050050050050050050050050050050050050050050050050050050050050050050050050050050050050050050050050050050050050050050050050050050050050050050050050050050050050050050050050050050050050050050050050050050050050050050050050050050050000000000000000000051051050050050050050050050050050050050050050050050050050050050050050050050050050050050050050050050050050050050050050050050
050050050050050050050050050050050050050050050050050050050050050050050050050050050050050050050050050050050050050050050050050050050050050050050050050050050050050050050050050050050050050050050050050050050050050050050050050050050050050050000000000000000000051051050050050050050050050050050050050050050050050051051051051051050050050050050050050050050050050050050050050050050050050
050050050050050050050050050050050050050050050050050050050050050050050050050050050050050050050050050050050050050050050050050050050050050050050050050050050050050050050050050050050050050050050050050050050050050050050050050050050050050050000000000000000000000000000000000000000000000000000000000000000000000000000000000000050050050050050050050050050050050050050050050050050050050
050050050050050050050050050050050050050050050050050050050050050050050050050050050050050050050050050050050050050050050050050050050050050050050050050050050050050050050050050050050050050050050050050050050050050050050050050050050050050050000000000000000000000000000000000000000000000000000000000000000000000000000000000000050050050050050050050050050050050050050050050050050050050
050050050050050050050050050050050050050050050050050050050050050050050050050050050050050050050050050050050050050050050050050050050050050050050050050050050050050050050050050050050050050050050050050050050050050050050050050050050050050050000000000000000000000000000000000000000000000000000000000000000000000000000000000000050050050050050050050050050050050050050050050050050050050
050050050050050050050050050050050050050050050050050050050050050050050050050050050050050050050050050050050050050050050050050050050050050050050050050050050050050050050050050050050050050050050050050050050050050050050050050050050050050050000000000000000000000000000000000000000000000000000000000000000000000000000000000000050050050050050050050050050050050050050050050050050050050
050050050050050050050050050050050050050050050050050050050050050050050050050050050050050050050050050050050050050050050050050050050050050050050050050050050050050050050050050050050050050050050050050050050050050050050050050050050050050050000000000000000000000000000000000000000000000000000000000000000000000000000000000000050050050050050050050050050050050050050050050050050050050